1 1 1 1 1 1 1 1 1 1 1 1 1 1 1 1 1 1 1 1 1 1 1 1 1 1 1 1 1 1 1 1 1 1 1 1
1 @ 0 0 0 $ 0 $ 0 1 0 0 $ $ $ $ $ 0 0 0 0 0 1 1 F 0 0 0 $ $ $ $ $ 1 $ 1
1 0 0 0 0 1 1 1 $ 1 0 0 $ $ $ $ $ 0 0 0 0 0 1 1 1 1 1 1 0 1 1 1 0 1 $ 1
1 0 1 1 0 1 1 1 0 1 1 1 1 1 1 1 1 1 1 1 0 0 1 0 0 0 0 0 $ 0 S $ $ 1 $ 1
1 0 0 1 0 0 $ 0 $ 1 0 0 0 0 0 0 0 0 0 0 0 0 1 0 $ 0 0 1 1 1 1 1 1 1 0 1
1 1 ^ 1 1 1 1 1 1 1 0 0 0 0 0 0 0 0 0 S 0 0 1 0 0 0 0 0 0 0 0 0 0 0 S 1
1 0 0 $ $ $ $ $ 0 1 1 0 1 0 0 0 0 0 0 0 0 S 1 1 1 1 1 1 1 0 0 0 0 0 0 1
1 1 0 0 0 0 0 0 0 0 S ! 1 $ $ $ 1 0 0 0 0 0 C 0 0 0 0 0 1 0 0 0 0 0 0 1
1 1 1 1 1 1 1 1 1 1 1 1 1 1 1 1 1 1 1 1 1 1 1 1 1 1 ^ ^ 1 1 1 ^ ^ 1 1 1
1 $ 0 1 0 1 0 1 0 1 0 1 0 0 0 0 0 0 1 0 0 0 0 0 0 0 S 0 1 0 1 0 0 0 0 1
1 1 0 1 0 1 0 1 0 1 0 1 0 0 0 0 0 0 1 $ 0 0 0 0 0 0 0 S 1 0 0 0 0 0 0 1
1 $ 0 0 0 $ 0 $ 0 $ 0 1 0 0 1 1 1 ^ 1 1 1 1 0 0 1 1 0 0 1 0 0 0 0 0 0 1
1 1 0 0 0 $ 0 $ 0 $ 0 1 0 0 1 0 0 0 1 0 0 0 1 1 0 0 0 0 1 0 0 0 0 0 0 1
1 $ 0 0 0 1 0 1 0 1 0 1 0 0 1 0 1 0 1 0 0 0 0 0 0 0 0 0 1 0 0 0 0 0 0 1
1 1 0 1 0 1 0 1 0 1 0 1 C 0 1 $ 1 $ 1 0 1 1 1 1 1 1 1 1 1 0 0 0 0 0 0 1
1 $ 0 1 0 1 0 1 0 1 0 1 0 0 1 0 1 1 1 0 1 0 S 0 0 0 0 0 0 0 0 0 0 0 0 1
1 1 B 0 B 0 B 0 B 0 B 0 0 0 1 0 0 0 0 0 1 0 0 0 0 0 0 0 0 0 0 0 0 0 0 1
1 $ 0 1 1 1 1 1 1 1 1 1 1 1 1 1 1 1 1 1 1 0 0 0 $ $ $ 0 0 0 0 0 0 0 0 1
1 1 0 0 0 0 0 0 0 0 0 0 0 0 0 0 0 0 0 0 0 0 0 0 $ $ $ 0 0 0 0 0 0 0 0 1
1 1 1 1 1 1 1 0 0 0 0 0 $ $ $ 0 0 0 > 0 0 0 0 0 $ $ $ 0 0 B B B B 0 0 1
1 0 0 0 0 0 0 0 0 0 0 0 0 0 0 0 0 0 0 0 0 0 0 0 0 0 0 C 0 0 0 0 0 0 0 1
1 1 1 1 1 1 1 1 1 1 1 1 1 1 1 1 1 1 1 1 1 1 1 1 1 1 1 1 1 1 1 1 1 1 1 1
1 0 0 0 0 0 0 0 S 0 0 S 0 0 S 0 0 S 0 0 S 0 0 0 S 0 0 0 S 0 0 S 0 0 S 1
1 0 0 0 0 0 0 0 S S 0 S 0 S 0 S S 0 S 0 0 0 S S 0 S 0 0 0 0 S 0 S 0 S 1
1 0 0 0 0 0 0 0 0 S 0 0 S 0 S S 0 0 S 0 S 0 0 0 0 0 0 S 0 0 0 S S 0 S 1
1 1 1 1 1 1 1 1 1 1 1 1 1 1 1 1 1 1 1 1 1 1 1 1 1 1 1 1 1 1 1 1 1 1 1 1
